    a b c d e f g h i j
  +---------------------+
X | r n b e q k C b n r | X
9 | l p p p p p p p p l | 9
8 | - - - - - - - - - - | 8
7 | - - - - - - - - - - | 7
6 | - - - - - - - - - - | 6
5 | - - - - - - - - - - | 5
4 | - - - - - - - - - - | 4
3 | - - - - - - - - - - | 3
2 | l P P P P P P P P l | 2
1 | R N B e Q K C B N R | 1
  +---------------------+
    a b c d e f g h i j
