	      a b c d e f g h i j k l m n o p q r s t u v w x y z α β γ δ ε ζ η θ ι κ λ μ Ν ξ ο π ρ Σ τ Υ φ χ ψ Ω
  +-----------------------------------------------------------------------------------------------------+
38| - - - - - - - - - - - - - - - - - - - - - - - - - - - - - - - - - - - - - - - - - - - - - - - - - - |33
37| - - - - - - - - - - - - - - - - - - - - - - - - - - - - - - - - - - - - - - - - - - - - - - - - - - |33
36| - - - - - - - - - - - - - - - - - - - - - - - - - - - - - - - - - - - - - - - - - - - - - - - - - - |33
35| - - - - - - - - - - - - - - - - - - - - - - - - - - - - - - - - - - - - - - - - - - - - - - - - - - |33
34| - - - - - - - - - - - - - - - - - - - - - - - - - - - - - - - - - - - - - - - - - - - - - - - - - - |33  
33| - - - - - - - - - - - - - - - - - - - - - - - - - - - - - - - - - - - - - - - - - - - - - - - - - - |33
32| - - - - - - - - - - - - - - - - - - - - - - - - - - - - - - - - - - - - - - - - - - - - - - - - - - |32
31| - - - - - - - - _______ - - _____ - - - - - - - - - - - - - - - - - - - - - - - - - - - - - - - - - |31
30| - - - - - - - -| - - - - - - - - |- - - - - - - - - - - - - - - - - - - - - - - - - - - - - - - - - |30
29| - - - - - - - -| - - - - - - - - |- - - - - - - - - - - - - - - - - - - - - - - - - - - - - - - - - |29
28| - - - - - - - -| - - - - - - - - |- - - - - - - - - - - - - - - - - - - - - - - - - - - - - - - - - |28
27| - - - - - - - -| - - - - ________|- - - - - - - - - - - - - - - - - - - - - - - - - - - - - - - - - |27
26| - - - - - - - -| - - - - | - - -  - - - - - - - - - - - - - - - - - - - - - - - - - - - - - - - - - |26
25| - - - - - - - -| - - - - | - - - |- - - - - - - - - - - - - - - - - - - - - - - - - - - - - - - - - |25
24| - - - - - - - -| - - - - | - - - |- - - - - - - - - - - - - - - - - - - - - - - - - - - - - - - - - |24
23| - - - - - - - -| - - - - | - - - |- - - - - - - - - - - - - - - - - - - - - - - - - - - - - - - - - |23
22| - - - - - - - - ‾‾‾‾‾‾‾ - - ‾‾‾‾‾ - - - - - - - - - - - - - - - - - - - - - - - - - - - - - - - - - |22
21| - - - - - - - - - - - - - - - - - - - - - - - - - - - - - - - - - - - - - - - - - - - - - - - - - - |21
20| - - - - - - - - - - - - - - - - - - - - ____ - - ____ - - - - - - - - - - - - - - - - - - - - - - - |20
19| - - - - - - - - - - - - - - - - - - -  - - - - - - - -  -  - - - - - - - - - - - - - - - - - - - -  |19
18| - - - - - - - - - - - - - - - - - - -| - - - - - - - - |- - - - - - - - - - - - - - - - - - - - - - |18
17| - - - - - - - - - - - - - - - - - - -| - - - - - - - - |- - - - - - - - - - - - - - - - - - - - - - |17
16| - - - - - - - - - - - - - - - - - - -| - - - - - - - - |- - - - - - - - - - - - - - - - - - - - - - |16
15| - - - - - - - - - - - - - - - - - - -  - - - - - - - -  - - - - - - - - - - - - - - - - - - - - - - |15
14| - - - - - - - - - - - - - - - - - - -| - - - - - - - - |- - - - - - - - - - - - - - - - - - - - - - |14
13| - - - - - - - - - - - - - - - - - - -| - - - - - - - - |- - - - - - - - - - - - - - - - - - - - - - |13
12| - - - - - - - - - - - - - - - - - - -| - - - - - - - -  - - - - - - - - - - - - - - - - - - - - - - |12
11| - - - - - - - - - - - - - - - - - - - -‾‾‾‾‾‾ - - ‾‾‾‾- - - - - - - - - - - - - - - - - - - - - - - |11
10| - - - - - - - - - - - - - - - - - - - - - - - - - - - - - - - - - - - - - - - - - - - - - - - - - - |10
9 | - - - - - - - - - - - - - - - - - - - - - - - - - - - - - - - - - - - - - - - - - - - - - - - - - - |9
8 | - - - - - - - - - - - - - - - - - - - - - - - - - - - - - - -______   - - - - - - - - - - - - - - - |8
7 | - - - - - - - - - - - - - - - - - - - - - - - - - - - - - - | - - - | - - - - - - - - - - - - - - - |7
6 | - - - - - - - - - - - - - - - - - - - - - - - - - - - - - - | - - - | - - - - - - - - - - - - - - - |6
5 | - - - - - - - - - - - - - - - - - - - - - - - - - - - - - - | - - - | - - - - - - - - - - - - - - - |5
4 | - - - - - - - - - - - - - - - - - - - - - - - - - - - - - - - - - - | - - - - - - - - - - - - - - - |4
3 | - - - - - - - - - - - - - - - - - - - - - - - - - - - - - -  ‾‾‾‾‾‾‾  - - - - - - - - - - - - - - - |3
2 | - - - - - - - - - - - - - - - - - - - - - - - - - - - - - - - - - - - - - - - - - - - - - - - - - - |2
1 | - - - - - - - - - - - - - - - - - - - - - - - - - - - - - - - - - - - - - - - - - - - - - - - - - - |1
  +-----------------------------------------------------------------------------------------------------+
   a b c d e f g h i j k l m n o p q r s t u v w x y z α β γ δ ε ζ η θ ι κ λ μ Ν ξ ο π ρ Σ τ Υ φ χ ψ Ω
